6 0 0 4 1 0 0 2 3 0 0 5 0 2 3 0 6 0 0 4 1 0 0 2 3 0 0 5 0 2 3 0 3 0 6 0 0 4 1 0 0 2 3 0 0 5 0 2 3 0
0 3 0 0 0 0 2 0 0 4 0 2 0 0 0 0 0 3 0 0 0 0 2 0 0 4 0 2 0 0 0 0 0 0 0 0 3 0 0 0 0 2 0 0 4 0 2 0 0 0
0 0 0 0 0 4 0 0 5 0 0 6 0 6 0 0 0 0 0 0 0 4 0 0 5 0 0 6 0 6 0 0 0 0 0 0 4 0 0 5 0 0 6 0 6 0 0 1 2 3
0 2 0 5 0 0 0 0 0 2 0 0 5 0 0 4 0 2 0 5 0 0 0 0 0 2 0 0 5 0 0 4 0 0 4 0 2 0 5 0 0 0 0 0 2 0 0 5 0 0
0 0 4 7 7 7 0 7 0 0 6 0 2 0 0 0 0 0 4 0 0 1 0 6 0 0 6 0 2 0 0 0 0 0 0 0 4 0 0 1 0 6 0 0 6 0 2 0 0 0
0 0 0 7 0 7 1 7 0 0 0 0 0 6 0 0 0 0 0 0 0 0 1 0 0 0 0 0 0 6 0 0 0 0 0 0 0 0 0 0 1 0 0 0 0 0 0 6 0 0
0 5 0 7 0 0 0 7 0 1 0 5 0 0 3 0 0 5 0 3 0 0 0 0 0 1 0 5 0 0 3 0 0 0 5 0 3 0 0 0 0 0 1 0 5 0 0 3 0 3
0 0 0 7 7 7 7 7 0 0 0 0 0 0 0 0 0 0 0 0 0 0 4 0 0 0 0 0 0 0 0 0 0 0 0 0 0 0 0 0 4 0 0 0 0 0 0 0 0 0
0 2 0 5 0 0 2 0 0 5 0 0 2 6 0 0 0 2 0 5 0 0 2 0 0 5 0 0 2 6 0 0 6 0 0 0 2 0 5 0 0 2 0 0 5 0 0 2 6 0
0 0 0 0 0 5 0 0 2 0 0 0 0 0 0 0 0 0 0 0 0 5 0 0 2 0 0 0 0 0 0 0 0 0 0 0 0 0 0 0 0 5 0 0 2 0 0 0 0 0
0 5 0 6 0 0 0 4 0 0 0 6 0 0 4 0 0 5 0 6 0 0 0 4 0 0 0 6 0 0 4 0 0 6 0 0 4 0 0 5 0 6 0 0 0 4 0 0 0 6
0 0 2 0 0 3 0 0 0 3 0 0 0 3 0 0 0 0 2 0 0 3 0 0 0 3 0 0 0 3 0 0 0 3 0 0 0 0 2 0 0 3 0 0 0 3 0 0 0 3
6 0 0 4 1 0 0 2 3 0 0 5 0 2 3 0 6 0 0 4 1 0 0 2 3 0 0 5 0 2 3 0 0 6 0 0 4 1 0 0 2 3 0 0 5 0 2 3 0 4
0 3 0 0 0 0 2 0 0 4 0 2 0 0 0 0 0 3 0 0 0 0 2 0 0 4 0 2 0 0 0 0 0 0 0 3 0 0 0 0 2 0 0 4 0 2 0 0 0 0
0 0 0 0 0 4 0 0 5 0 0 6 0 6 0 0 0 0 0 0 0 4 0 0 5 0 0 6 0 6 0 0 0 0 0 0 0 0 0 4 0 0 5 0 0 6 0 6 0 0
0 2 0 5 0 0 0 0 0 2 0 0 5 0 0 4 0 2 0 5 0 0 0 0 0 2 0 0 5 0 0 4 0 4 0 2 0 5 0 0 0 0 0 2 0 0 5 0 0 4
0 0 4 0 0 1 0 6 0 0 6 0 2 0 0 0 0 0 4 0 0 1 0 6 0 0 6 0 2 0 0 0 0 0 0 0 4 0 0 1 0 6 0 0 6 0 2 0 0 0
0 0 0 0 0 0 1 0 0 0 0 0 0 6 0 0 0 0 0 0 0 0 1 0 0 0 0 0 0 6 0 0 0 0 0 0 0 0 0 0 1 0 0 0 0 0 0 6 0 0
6 0 0 4 1 0 0 2 3 0 0 5 0 2 3 0 6 0 0 4 1 0 0 2 3 0 0 5 0 2 3 0 3 0 6 0 0 4 1 0 0 2 3 0 0 5 0 2 3 0
0 3 0 0 0 0 2 0 0 4 0 2 0 0 0 0 0 3 0 0 0 0 2 0 0 4 0 2 0 0 0 0 0 0 0 0 3 0 0 0 0 2 0 0 4 0 2 0 0 0
0 0 0 0 0 4 0 0 5 0 0 6 0 6 0 0 0 0 0 0 0 4 0 0 5 0 0 6 0 6 0 0 0 0 0 0 4 0 0 5 0 0 6 0 6 0 0 1 2 3
0 2 0 5 0 0 0 0 0 2 0 0 5 0 0 4 0 2 0 5 0 0 0 0 0 2 0 0 5 0 0 4 0 0 4 0 2 0 5 0 0 0 0 0 2 0 0 5 0 0
0 0 4 0 0 1 0 6 0 0 6 0 2 0 0 0 0 0 4 0 0 1 0 6 0 0 6 0 2 0 0 0 0 0 0 0 4 0 0 1 0 6 0 0 6 0 2 0 0 0
0 0 0 0 0 0 1 0 0 0 0 0 0 6 0 0 0 0 0 0 0 0 1 0 0 0 0 0 0 6 0 0 0 0 0 0 0 0 0 0 1 0 0 0 0 0 0 6 0 0
0 5 0 3 0 0 0 0 0 1 0 5 0 0 3 0 0 5 0 3 0 0 0 0 0 1 0 5 0 0 3 0 0 0 5 0 3 0 0 0 0 0 1 0 5 0 0 3 0 3
0 0 0 0 0 0 4 0 0 0 0 0 0 0 0 0 0 0 0 0 0 0 4 0 0 0 0 0 0 0 0 0 0 0 0 0 0 0 0 0 4 0 0 0 0 0 0 0 0 0
0 2 0 5 0 0 2 0 0 5 0 0 2 6 0 0 0 2 0 5 0 0 2 0 0 5 0 0 2 6 0 0 6 0 0 0 2 0 5 0 0 2 0 0 5 0 0 2 6 0
0 0 0 0 0 5 0 0 2 0 0 0 0 0 0 0 0 0 0 0 0 5 0 0 2 0 0 0 0 0 0 0 0 0 0 0 0 0 0 0 0 5 0 0 2 0 0 0 0 0
0 5 0 6 0 0 0 4 0 0 0 6 0 0 4 0 0 5 0 6 0 0 0 4 0 0 0 6 0 0 4 0 0 6 0 0 4 0 0 5 0 6 0 0 0 4 0 0 0 6
0 0 2 0 0 3 0 0 0 3 0 0 0 3 0 0 0 0 2 0 0 3 0 0 0 3 0 0 0 3 0 0 0 3 0 0 0 0 2 0 0 3 0 0 0 3 0 0 0 3
6 0 0 4 1 0 0 2 3 0 0 5 0 2 3 0 6 0 0 4 1 0 0 2 3 0 0 5 0 2 3 0 0 6 0 0 4 1 0 0 2 3 0 0 5 0 2 3 0 4
0 3 0 0 0 0 2 0 0 4 0 2 0 0 0 0 0 3 0 0 0 0 2 0 0 4 0 2 0 0 0 0 0 0 0 3 0 0 0 0 2 0 0 4 0 2 0 0 0 0
0 0 0 0 0 4 0 0 5 0 0 6 0 6 0 0 0 0 0 0 0 4 0 0 5 0 0 6 0 6 0 0 0 0 0 0 0 0 0 4 0 0 5 0 0 6 0 6 0 0
0 2 0 5 0 0 0 0 0 2 0 0 5 0 0 4 0 2 0 5 0 0 0 0 0 2 0 0 5 0 0 4 0 4 0 2 0 5 0 0 0 0 0 2 0 0 5 0 0 4
0 0 4 0 0 1 0 6 0 0 6 0 2 0 0 0 0 0 4 0 0 1 0 6 0 0 6 0 2 0 0 0 0 0 0 0 4 0 0 1 0 6 0 0 6 0 2 0 0 0
0 0 0 0 0 0 1 0 0 0 0 0 0 6 0 0 0 0 0 0 0 0 1 0 0 0 0 0 0 6 0 0 0 0 0 0 0 0 0 0 1 0 0 0 0 0 0 6 0 0
6 0 0 4 1 0 0 2 3 0 0 5 0 2 3 0 6 0 0 4 1 0 0 2 3 0 0 5 0 2 3 0 3 0 6 0 0 4 1 0 0 2 3 0 0 5 0 2 3 0
0 3 0 0 0 0 2 0 0 4 0 2 0 0 0 0 0 3 0 0 0 0 2 0 0 4 0 2 0 0 0 0 0 0 0 0 3 0 0 0 0 2 0 0 4 0 2 0 0 0
0 0 0 0 0 4 0 0 5 0 0 6 0 6 0 0 0 0 0 0 0 4 0 0 5 0 0 6 0 6 0 0 0 0 0 0 4 0 0 5 0 0 6 0 6 0 0 1 2 3
0 2 0 5 0 0 0 0 0 2 0 0 5 0 0 4 0 2 0 5 0 0 0 0 0 2 0 0 5 0 0 4 0 0 4 0 2 0 5 0 0 0 0 0 2 0 0 5 0 0
0 0 4 0 0 1 0 6 0 0 6 0 2 0 0 0 0 0 4 0 0 1 0 6 0 0 6 0 2 0 0 0 0 0 0 0 4 0 0 1 0 6 0 0 6 0 2 0 0 0
0 0 0 0 0 0 1 0 0 0 0 0 0 6 0 0 0 0 0 0 0 0 1 0 0 0 0 0 0 6 0 0 0 0 0 0 0 0 0 0 1 0 0 0 0 0 0 6 0 0
0 5 0 3 0 0 0 0 0 1 0 5 0 0 3 0 0 5 0 3 0 0 0 0 0 1 0 5 0 0 3 0 0 0 5 0 3 0 0 0 0 0 1 0 5 0 0 3 0 3
0 0 0 0 0 0 4 0 0 0 0 0 0 0 0 0 0 0 0 0 0 0 4 0 0 0 0 0 0 0 0 0 0 0 0 0 0 0 0 0 4 0 0 0 0 0 0 0 0 0
0 2 0 5 0 0 2 0 0 5 0 0 2 6 0 0 0 2 0 5 0 0 2 0 0 5 0 0 2 6 0 0 6 0 0 0 2 0 5 0 0 2 0 0 5 0 0 2 6 0
0 0 0 0 0 5 0 0 2 0 0 0 0 0 0 0 0 0 0 0 0 5 0 0 2 0 0 0 0 0 0 0 0 0 0 0 0 0 0 0 0 5 0 0 2 0 0 0 0 0
0 5 0 6 0 0 0 4 0 0 0 6 0 0 4 0 0 5 0 6 0 0 0 4 0 0 0 6 0 0 4 0 0 6 0 0 4 0 0 5 0 6 0 0 0 4 0 0 0 6
0 0 2 0 0 3 0 0 0 3 0 0 0 3 0 0 0 0 2 0 0 3 0 0 0 3 0 0 0 3 0 0 0 3 0 0 0 0 2 0 0 3 0 0 0 3 0 0 0 3
6 0 0 4 1 0 0 2 3 0 0 5 0 2 3 0 6 0 0 4 1 0 0 2 3 0 0 5 0 2 3 0 0 6 0 0 4 1 0 0 2 3 0 0 5 0 2 3 0 4
0 3 0 0 0 0 2 0 0 4 0 2 0 0 0 0 0 3 0 0 0 0 2 0 0 4 0 2 0 0 0 0 0 0 0 3 0 0 0 0 2 0 0 4 0 2 0 0 0 0
